#.#########
#.........#
#####.#.#.#
#.....#.#.#
#.###.#####
#...#.....#
#.###.#####
#...#.#...#
#####.###.#
#.........#
#########.#